#####################
#       R           #
#  G             B  #
#            R      #
#  G     B          #
#####################
