#####################
#                   #
#     I             #
#                   #
#                   #
#       ##### R     #
#           #       #
#         G #       #
#    ########       #
#                   #
#       T        B  #
####  ##     R      #
#  G     B          #
#####################
