#####################
#                   #
#                   #
#                   #
#                   #
#                   #
############        #
#          #        #
#          #        #
#          #        #
#          #        #
#          #        #
#          #        #
#####################
