#####################
#                   #
#                   #
#                   #
#                   #
#                   #
############        #
#          #        #
#  R    G  #        #
#          #        #
#   R      #        #
#       B  #        #
#          #        #
#####################
